00 00 00 00 00 00 00 00 00 00 00 00 00 00 00 00 00 00 00 00 00 00 00 00 00 00 00 00 00 00 00 00 00 00 00 00 00 00 00 12 10 10 10 10 10 10
00 00 00 00 00 00 00 00 00 00 00 00 00 00 00 00 00 00 00 00 00 00 00 00 00 00 00 00 00 00 00 00 00 00 00 00 00 00 00 12 10 10 10 10 10 10
00 00 00 00 00 00 00 00 00 00 00 00 00 00 00 00 00 00 00 00 00 00 00 00 00 00 00 00 00 00 00 00 00 00 00 00 00 00 00 12 10 10 10 10 10 10
00 00 00 00 00 00 00 00 00 00 00 00 00 00 00 00 00 00 00 00 00 00 00 00 00 00 00 00 00 00 00 00 00 00 00 00 00 00 00 12 10 11 10 10 10 10
00 00 00 00 00 00 00 00 00 00 00 00 00 00 00 00 00 00 00 00 00 00 00 00 00 00 00 00 00 00 00 00 00 00 00 00 00 00 00 12 10 10 10 10 10 10
00 00 00 00 00 00 00 00 00 00 00 00 00 00 00 00 00 00 00 00 00 00 00 00 00 00 00 00 00 00 00 00 00 00 00 00 00 00 00 12 10 10 10 10 10 10
00 00 00 00 00 00 00 00 00 00 00 00 00 00 00 00 00 00 00 00 00 00 00 00 00 00 00 00 00 00 00 00 00 00 00 00 00 00 00 12 10 10 10 10 10 10
00 00 00 00 00 00 00 00 00 00 00 00 00 00 00 00 00 00 00 00 00 00 00 00 00 00 00 00 00 00 00 00 00 00 00 00 00 00 00 12 10 10 10 10 10 10
00 00 00 00 00 00 00 00 00 00 00 00 00 00 00 00 00 00 00 00 00 00 00 00 00 00 00 00 00 00 00 00 00 00 00 00 00 00 00 12 10 10 10 10 10 10
06 01 01 01 01 01 01 01 01 01 01 01 01 01 01 01 01 01 01 01 01 01 01 01 01 01 01 01 01 01 01 01 01 01 01 01 01 01 05 12 10 10 10 10 10 10
08 02 02 02 02 02 12 11 02 02 02 02 02 02 02 02 02 02 02 02 02 02 12 11 02 02 02 02 02 02 02 02 02 02 02 02 02 02 07 12 10 10 10 11 10 10
00 00 00 00 00 00 04 03 00 00 00 00 00 00 00 00 00 00 00 00 00 00 04 03 00 00 00 00 00 00 00 00 00 00 00 00 00 00 00 12 10 11 10 10 10 10
00 00 00 00 00 00 04 03 00 00 00 00 00 19 19 19 19 00 00 00 00 00 04 03 00 00 00 00 00 00 00 00 00 00 00 00 00 00 00 12 10 10 10 10 10 10
00 00 00 00 00 00 04 03 00 00 00 00 00 00 00 00 00 00 00 00 00 00 04 03 00 00 00 00 00 00 00 00 00 00 00 00 00 00 00 12 10 10 11 10 10 10
00 00 00 00 00 00 04 03 00 00 00 00 00 00 00 00 00 00 00 00 00 00 04 03 00 00 00 00 00 00 00 00 00 00 00 00 00 00 00 12 10 10 10 10 10 10
00 00 00 00 00 00 04 03 00 00 00 00 00 00 00 00 00 00 00 00 00 00 04 03 00 00 00 00 00 00 00 00 00 00 00 00 00 00 00 12 10 10 10 10 10 10
00 00 00 00 00 00 04 03 00 00 00 00 00 00 00 00 00 00 00 00 00 00 04 03 00 00 00 00 00 00 00 00 00 00 00 00 00 00 00 12 10 11 11 10 10 10
00 00 00 00 00 00 04 03 00 00 00 00 00 00 00 00 00 00 00 00 00 00 04 03 00 00 00 00 00 00 00 00 00 00 00 00 00 00 00 12 10 10 10 10 10 10
00 00 00 00 00 00 04 03 00 00 00 00 00 00 00 00 00 00 00 00 00 00 04 03 00 00 00 00 00 00 00 00 00 00 00 00 00 00 00 12 10 10 10 10 10 10
06 01 01 01 01 01 10 09 01 01 01 01 01 01 01 01 01 01 01 01 01 01 10 09 01 01 01 01 01 01 01 01 01 01 01 01 01 01 05 12 10 10 10 10 10 10
08 02 02 02 02 02 02 02 02 02 02 02 02 02 02 02 02 02 02 02 02 02 02 02 02 02 02 02 02 02 02 02 02 02 02 02 02 02 07 12 10 10 10 10 10 10
00 00 00 00 00 00 00 00 00 00 00 00 00 00 00 00 00 00 00 00 00 00 00 00 00 00 00 00 00 00 00 00 00 00 00 00 00 00 00 12 10 10 10 10 10 10
00 00 00 00 00 00 00 00 00 00 00 00 00 00 00 00 00 00 00 00 00 00 00 00 00 00 00 00 00 00 00 00 00 00 00 00 00 00 00 12 10 10 10 10 10 10
00 00 00 00 00 00 00 00 00 00 00 00 00 00 00 00 00 00 00 00 00 00 00 00 00 00 00 00 00 00 00 00 00 00 00 00 00 00 00 12 10 10 10 10 10 10
00 00 00 00 00 00 00 00 00 00 00 00 00 00 00 00 00 00 00 00 00 00 00 00 00 00 00 00 00 00 00 00 00 00 00 00 00 00 00 12 10 10 10 10 10 10
00 00 00 00 00 00 00 00 00 00 00 00 00 00 00 00 00 00 00 00 00 00 00 00 00 00 00 00 00 00 00 00 00 00 00 00 00 00 00 12 10 10 10 10 10 10
00 00 00 00 00 00 00 00 00 00 00 00 00 00 00 00 00 00 00 00 00 00 00 00 00 00 00 00 00 00 00 00 00 00 00 00 00 00 00 12 10 10 10 10 10 10
00 00 00 00 00 00 00 00 00 00 00 00 00 00 00 00 00 00 00 00 00 00 00 00 00 00 00 00 00 00 00 00 00 00 00 00 00 00 00 12 10 10 10 10 10 10
00 00 00 00 00 00 00 00 00 00 00 00 00 00 00 00 00 00 00 00 00 00 00 00 00 00 00 00 00 00 00 00 00 00 00 00 00 00 00 12 10 10 10 10 10 10
00 00 00 00 00 00 00 00 00 00 00 00 00 00 00 00 00 00 00 00 00 00 00 00 00 00 00 00 00 00 00 00 00 00 00 00 00 00 00 12 10 10 10 10 10 10
